A	AH
A(2)	EY
ARE	AA R
ARE(2)	ER
BLUE	B L UW
DOING	D UW IH NG
FIRE	F AY ER
FIRE(2)	F AY R
GREEN	G R IY N
HAY	HH EY
HELLO	HH AH L OW
HELLO(2)	HH EH L OW
HEY	HH EY
HI	HH AY
HIGH	HH AY
HOW	HH AW
IS	IH Z
JUMP	JH AH M P
LIGHTS	L AY T S
MISTER	M IH S T ER
OFF	AO F
ON	AA N
ON(2)	AO N
PHOTO	F OW T OW
PICTURE	P IH K CH ER
RED	R EH D
SELFIE	S EH L F IY
TAKE	T EY K
THE	DH AH
THE(2)	DH IY
TRUMAN	T R UW M AH N
TURN	T ER N
UP	AH P
WHAT	W AH T
WHAT(2)	HH W AH T
WHATS	W AH T S
WHATS(2)	HH W AH T S
YOU	Y UW
